16
9
w w w w w w w w w w w w w w w w
w x x x x x x x x x x x x x x w
w x x x x x x x x x x x x x x w
w x x x x x x x x x x x x x x w
w x x x x x x x x x x x x x e w
w x x x x x x x x x x x x w w w
w x x x x x x x x x x x x w w w
w p x c x x x x x x x x x w w w
w w w w w w w w w w w w w w w w