16
9
w w w w w w w w w w w w w w w w
w x x x x x x x x x x x x x x w
w x x x x x x x x x x x x x x w
w x x x x x x x x x x x x x x w
w b1 x x x x x x x x x x x x x w
w w x x x x x x x x x x x x x w
w w x x x x x x x x x x x m12 m13 w
w w x x x c x p x x x x x m11 e w
w w w w w w w w w w w w w w w w

11 13 7 13 3
12 13 6 13 2
13 14 6 14 2