16
9
w w w w w w w w w w w w w w w w
w x x x x x x x x x w s w w w w
w k1 x x x x x x x x x d1 w w w w
w w x x x x x x w w w x w w w w
w w w x x x x x x x x x x x e w
w w w w x x x w w w w x w w w w
w x x x x x x w w w w x w w w w
w x p x x w w w w w w x x w w w
w w w w w w w w w w w w x w w w