16
9
w w w w w w w w w w w w w w w w
w x x x x x x x x x x x x x x w
w x x x x x x x x x x x w x x w
w x x x x x x x x x x x w x x w
w p x x x x x x x x x x w x x w
w w w w w w x x x x w w w x w w
w x x x x x x x x x x x w x x w
w x x x x s x x x x x x w x e w
w w w w w w w w w w w x w w w w