16
9
w w w w w w w w w w w w w w w w
w x x x x x x x x x x x x x x w
w x x x x x x x x x x x x x x w
w x x x x x x x x x x x x x x w
w x x x x x x x x x x x x x x w
w x x x x x x x x x x x x x x w
w x x x x x x x x x x x x x x w
w p x x x x x x x x x x x x e w
w w w w w w w w w w w w w w w w