16
9
w w w w w w w w w w w w w w w w
w x x x x x x x x x x x x x x w
w x x x x x x x x x x x x x x w
w x x x x x x x x x x x x x x w
w x x x k1 x x x x x x x x x x w
w x x x w x x x x x x x x x s w
w x x x x x x x x x x x w w w w
w p x x x x x x x x x x d1 x e w
w w w w w w w w w w w w w w w w